*****************
**************44***************
****11**22**11**11**22**11*****
1*2*3*4*5*6*1*2*3*4*5*6*1*2*3*4
4*3*2*1*6*5*4*3*2*1*6*5*4*3*2*1
****11**22**11**11**22**11*****
**************44***************